1 1 1 1 1 1 1 1 1 1 1 
1 5 1 3 2 3 1 3 1 3 1 
1 2 1 1 1 2 1 2 1 2 1 
1 3 2 3 1 3 1 6 1 3 1 
1 2 1 1 1 2 1 2 1 2 1 
1 3 2 6 2 3 2 3 2 3 1 
1 2 1 1 1 2 1 1 1 2 1 
1 3 2 3 1 3 1 4 2 3 1 
1 2 1 1 1 2 1 1 1 2 1 
1 3 2 3 2 3 1 3 2 3 1 
1 1 1 1 1 1 1 1 1 1 1 
